estandares js:
1.constantes
2.variables
3.punto y coma
4.funciones
5.funciones flecha

estandares php:
1.variables
2.funciones
3.clases (pasacal case)

Documentación
__construct - constructor
AcceptPageBreak - acepta o no un salto de página automático
AddFont - añade una nueva fuente
AddLink - crea una referencia interna
AddPage - añade una nueva página
AliasNbPages - define un alias para el número de páginas
Cell - imprime un celda
Close - termina el documento
Error - error fatal
Footer - pie de página
GetPageHeight - devuelve la altura actual de la página
GetPageWidth - devuelve el ancho actual de la página
GetStringWidth - calcula la longitud de la cadena
GetX - obtiene la posición actual de x
GetY - obtiene la posición actual de y
Header - cabecera de página
Image - imprime una imagen
Line - dibuja un línea
Link - pone una referencia
Ln - salto de línea
MultiCell - imprime texto con saltos de línea
Output - guarda o envía el documento
PageNo - número de página
Rect - dibuja un rectangulo
SetAuthor - establece el autor del documento
SetAutoPageBreak - establece el modo de salto de pagina automático
SetCompression - cambia la compresión en activo o inactivo
SetCreator - establece el creador del documento
SetDisplayMode - establece el modo de presentación
SetDrawColor - establece el color de graficación
SetFillColor - establece el color de relleno
SetFont - establece la fuente
SetFontSize - establece el tamaño de la fuente
SetKeywords - asocia las palabras claves con el documento
SetLeftMargin - establece el márgen izquierdo
SetLineWidth - establece el ancho de la línea
SetLink - establece el enlace de destino
SetMargins - establece los márgenes
SetRightMargin - establece el márgen derecho
SetSubject - establece el tema del documento
SetTextColor - establece el color del texto
SetTitle - establece el título del documento
SetTopMargin - Establece el márgen superior
SetX - establece la posición actual de x
SetXY - establece la posición actual de x y y
SetY - establece la posición actual de y
Text - imprime una cadena
Write - imprime el siguiente texto